1 1 1 1 1 1 1 0 0 0 0 1 1 0 1 0
0.15 0.15 0.15 0.15 0.15 0.15 0.15 0.15 0.15 0.15 0.15 0.15 0.15 0.15 0.15 0.15
381 381 381 381 381 381 381 381 381 381 381 381 381 381 381 381
502 552 492 452 492 552 472 331 227 540 277 396 640 193 491 256
674 650 588 492 382 273 177 115 91 115 177 273 382 492 588 650 674 674 674 528 382 237 91 91 91 91 91 237 382 528 674 674 674 674 528 528 382 237 237 91 91 91 237 237 382 528 528 674 663 603 510 424 341 255 161 102 102 161 255 341 424 510 603 663 674 549 466 434 330 299 216 91 91 216 299 330 434 466 549 674 614 554 497 442 382 323 263 206 151 91 187 284 382 481 575 674 658 632 455 382 310 133 107 258 107 133 310 382 455 632 658 507 91 128 164 200 237 273 310 341 424 460 497 533 570 606 642 674 91 128 167 206 245 284 323 362 401 440 479 518 557 596 635 674 91 91 91 91 107 156 232 323 442 533 609 658 674 674 674 674 91 143 174 190 211 239 284 354 434 476 497 533 616 637 658 674 382 341 237 133 91 133 237 341 382 424 528 632 674 632 528 424 616 476 401 382 364 289 148 91 91 133 237 382 528 632 674 674 91 91 174 174 258 258 341 341 424 424 507 507 590 590 674 674 507 382 258 234 112 174 112 234 258 382 507 531 653 601 653 531 91 128 135 154 206 271 315 349 416 450 494 559 611 629 637 674
400 291 194 132 109 132 194 291 400 509 605 668 691 668 605 509 400 254 109 109 109 109 109 254 400 545 691 691 691 691 691 545 400 254 254 109 109 109 254 254 400 545 545 691 691 691 545 545 348 275 254 298 298 254 275 348 452 525 545 501 501 545 525 452 343 309 220 109 109 220 309 343 457 491 579 691 691 579 491 457 574 457 340 223 109 223 340 457 574 691 691 691 691 691 691 691 317 150 124 275 124 150 317 400 483 649 675 525 675 649 483 400 109 192 275 358 441 525 608 691 691 608 525 441 358 275 192 109 566 566 566 566 566 566 566 566 566 566 566 566 566 566 566 566 109 205 301 400 493 584 649 686 686 649 584 493 400 301 205 109 233 301 374 457 540 610 681 639 649 584 501 428 436 358 275 192 400 506 545 506 400 293 249 293 400 506 545 506 400 293 249 293 140 129 257 400 257 129 140 270 415 548 649 691 649 548 415 270 358 441 441 525 525 608 608 691 691 608 608 525 525 441 441 358 135 192 135 252 280 400 519 548 681 608 681 548 519 400 280 252 405 457 522 582 618 618 587 530 530 587 618 618 582 522 457 405
