1 1 1 1 1 1 1 0 0 0 0 1 1 0 1 0
0.15 0.15 0.15 0.15 0.15 0.15 0.15 0.15 0.15 0.15 0.15 0.15 0.15 0.15 0.15 0.15
381 381 381 381 381 381 381 381 381 381 381 381 381 381 381 381
502 552 492 452 492 552 472 331 227 540 277 396 640 193 491 256
674 650 588 492 382 273 177 115 91 115 177 273 382 492 588 650 674 674 674 528 382 237 91 91 91 91 91 237 382 528 674 674 674 674 528 528 382 237 237 91 91 91 237 237 382 528 528 674 663 603 510 424 341 255 161 102 102 161 255 341 424 510 603 663 674 549 466 434 330 299 216 91 91 216 299 330 434 466 549 674 614 554 497 442 382 323 263 206 151 91 187 284 382 481 575 674 658 632 455 382 310 133 107 258 107 133 310 382 455 632 658 507 91 128 164 200 237 273 310 341 424 460 497 533 570 606 642 674 91 128 167 206 245 284 323 362 401 440 479 518 557 596 635 674 91 91 91 91 107 156 232 323 442 533 609 658 674 674 674 674 91 143 174 190 211 239 284 354 434 476 497 533 616 637 658 674 382 341 237 133 91 133 237 341 382 424 528 632 674 632 528 424 616 476 401 382 364 289 148 91 91 133 237 382 528 632 674 674 91 91 174 174 258 258 341 341 424 424 507 507 590 590 674 674 507 382 258 234 112 174 112 234 258 382 507 531 653 601 653 531 91 128 135 154 206 271 315 349 416 450 494 559 611 629 637 674
440 331 234 172 149 172 234 331 440 549 645 708 731 708 645 549 440 294 149 149 149 149 149 294 440 585 731 731 731 731 731 585 440 294 294 149 149 149 294 294 440 585 585 731 731 731 585 585 388 315 294 338 338 294 315 388 492 565 585 541 541 585 565 492 383 349 260 149 149 260 349 383 497 531 619 731 731 619 531 497 614 497 380 263 149 263 380 497 614 731 731 731 731 731 731 731 357 190 164 315 164 190 357 440 523 689 715 565 715 689 523 440 149 232 315 398 481 565 648 731 731 648 565 481 398 315 232 149 606 606 606 606 606 606 606 606 606 606 606 606 606 606 606 606 149 245 341 440 533 624 689 726 726 689 624 533 440 341 245 149 273 341 414 497 580 650 721 679 689 624 541 468 476 398 315 232 440 546 585 546 440 333 289 333 440 546 585 546 440 333 289 333 180 169 297 440 297 169 180 310 455 588 689 731 689 588 455 310 398 481 481 565 565 648 648 731 731 648 648 565 565 481 481 398 175 232 175 292 320 440 559 588 721 648 721 588 559 440 320 292 445 497 562 622 658 658 627 570 570 627 658 658 622 562 497 445 