1 1 1 1 1 1 1 0 0 0 0 1 1 0 1 0
0.25 0.25 0.33 0.25 0.25 0.25 0.33 0.25 0.20 0.25 0.25 0.25 0.25 0.25 0.25 0.20
380 380 380 380 380 380 380 380 380 380 380 380 380 380 380 380
380 380 380 380 380 380 380 380 380 380 380 380 380 380 380 380
720 693 621 510 384 258 147 75 48 75 147 258 384 510 621 693 720 720 720 552 384 216 48 48 48 48 48 216 384 552 720 720 720 720 552 552 384 216 216 48 48 48 216 216 384 552 552 720 708 639 531 432 336 237 129 60 60 129 237 336 432 531 639 708 720 576 480 444 324 288 192 48 48 192 288 324 444 480 576 720 651 582 516 453 384 315 246 180 117 48 159 270 384 498 606 720 702 672 468 384 300 96 66 240 66 96 300 384 468 672 702 528 48 90 132 174 216 258 300 336 432 474 516 558 600 642 684 720 48 90 135 180 225 270 315 360 405 450 495 540 585 630 675 720 48 48 48 48 66 123 210 315 453 558 645 702 720 720 720 720 48 108 144 162 186 219 270 351 444 492 516 558 654 678 702 720 384 336 216 96 48 96 216 336 384 432 552 672 720 672 552 432 654 492 405 384 363 276 114 48 48 96 216 384 552 672 720 720 48 48 144 144 240 240 336 336 432 432 528 528 624 624 720 720 528 384 240 213 72 144 72 213 240 384 528 555 696 636 696 555 48 90 99 120 180 255 306 345 423 462 513 588 648 669 678 720
381 255 144 72 45 72 144 255 381 507 618 690 717 690 618 507 381 213 45 45 45 45 45 213 381 549 717 717 717 717 717 549 381 213 213 45 45 45 213 213 381 549 549 717 717 717 549 549 321 237 213 264 264 213 237 321 441 525 549 498 498 549 525 441 315 276 174 45 45 174 276 315 447 486 588 717 717 588 486 447 582 447 312 177 45 177 312 447 582 717 717 717 717 717 717 717 285 93 63 237 63 93 285 381 477 669 699 525 699 669 477 381 45 141 237 333 429 525 621 717 717 621 525 429 333 237 141 45 573 573 573 573 573 573 573 573 573 573 573 573 573 573 573 573 45 156 267 381 489 594 669 711 711 669 594 489 381 267 156 45 189 267 351 447 543 624 705 657 669 594 498 414 423 333 237 141 381 504 549 504 381 258 207 258 381 504 549 504 381 258 207 258 81 69 216 381 216 69 81 231 399 552 669 717 669 552 399 231 333 429 429 525 525 621 621 717 717 621 621 525 525 429 429 333 75 141 75 210 243 381 519 552 705 621 705 552 519 381 243 210 387 447 522 591 633 633 597 531 531 597 633 633 591 522 447 387
