1 1 1 1 1 1 1 0 0 0 0 1 1 0 1 0
0.25 0.25 0.33 0.25 0.25 0.25 0.33 0.25 0.20 0.25 0.25 0.25 0.25 0.25 0.25 0.20
380 380 380 380 380 380 380 380 380 380 380 380 380 380 380 380
380 380 380 380 380 380 380 380 380 380 380 380 380 380 380 380
89 112 174 271 380 489 585 648 671 648 585 489 380 271 174 112 89 89 89 234 380 525 671 671 671 671 671 525 380 234 89 89 89 89 234 234 380 525 525 671 671 671 525 525 380 234 234 89 99 159 252 338 421 507 601 661 661 601 507 421 338 252 159 99 89 213 297 328 432 463 546 671 671 546 463 432 328 297 213 89 148 208 265 320 380 440 499 557 611 671 575 479 380 281 187 89 104 130 307 380 453 629 655 505 655 629 453 380 307 130 104 255 671 635 598 562 525 489 453 421 338 302 265 229 193 156 120 89 671 635 596 557 518 479 440 401 362 323 284 245 206 167 128 89 671 671 671 671 655 606 531 440 320 229 154 104 89 89 89 89 671 619 588 572 551 523 479 408 328 286 265 229 146 125 104 89 380 421 525 629 671 629 525 421 380 338 234 130 89 130 234 338 146 286 362 380 398 473 614 671 671 629 525 380 234 130 89 89 671 671 588 588 505 505 421 421 338 338 255 255 172 172 89 89 255 380 505 528 650 588 650 528 505 380 255 232 109 161 109 232 671 635 627 609 557 492 447 414 346 312 268 203 151 133 125 89
400 291 194 132 109 132 194 291 400 509 605 668 691 668 605 509 400 254 109 109 109 109 109 254 400 545 691 691 691 691 691 545 400 254 254 109 109 109 254 254 400 545 545 691 691 691 545 545 348 275 254 298 298 254 275 348 452 525 545 501 501 545 525 452 343 309 220 109 109 220 309 343 457 491 579 691 691 579 491 457 574 457 340 223 109 223 340 457 574 691 691 691 691 691 691 691 317 150 124 275 124 150 317 400 483 649 675 525 675 649 483 400 109 192 275 358 441 525 608 691 691 608 525 441 358 275 192 109 566 566 566 566 566 566 566 566 566 566 566 566 566 566 566 566 109 205 301 400 493 584 649 686 686 649 584 493 400 301 205 109 233 301 374 457 540 610 681 639 649 584 501 428 436 358 275 192 400 506 545 506 400 293 249 293 400 506 545 506 400 293 249 293 140 129 257 400 257 129 140 270 415 548 649 691 649 548 415 270 358 441 441 525 525 608 608 691 691 608 608 525 525 441 441 358 135 192 135 252 280 400 519 548 681 608 681 548 519 400 280 252 405 457 522 582 618 618 587 530 530 587 618 618 582 522 457 405
